2 2 2 2 2 2 2 2 2 2 2 2 2 2 2 2 2 2 2 2
2 2 2 2 2 2 2 2 2 2 2 2 2 2 2 2 2 2 2 2
2 2 2 2 9 4 4 4 4 4 4 4 4 4 4 4 4 4 11 2
2 2 2 2 5 1 1 1 1 1 1 17 18 18 18 19 1 1 6 2
2 2 2 8 12 1 1 1 1 1 1 24 20 20 20 25 1 1 6 2
2 2 2 5 1 1 1 1 1 1 1 24 20 20 20 25 1 1 6 2
2 2 2 5 1 1 1 1 1 1 1 24 20 20 20 25 1 1 6 2
2 2 2 5 1 1 1 1 1 1 1 21 22 22 22 23 1 1 6 2
2 2 2 5 1 1 1 1 1 1 1 1 1 1 1 1 13 3 7 2
2 2 2 0 3 10 1 1 1 1 13 3 3 3 3 3 7 15 2 2
2 2 2 2 2 0 3 3 3 3 7 14 2 2 2 2 2 2 2 2
2 2 2 2 2 2 2 2 2 2 2 2 2 2 2 2 2 2 2 2

 